################################
#                            O #
#                           ####
#    P                         #
#######                        #
#  O ##                        #
#    ##                        #
#                              #
#      XX                      #
#      #                       #
################################